11111111
1P000001
111111C1
1C0E0001
11111111
