11111111
1P000001
111011C1
101E0011
11111111
11111111
