11111
11C11
11E11
11P11
11111
