11111111111
10100011111
1C0E1111111
11111111111
