11111111111
1P000011111
1CE11111111
11111111111
