1111111111111111111111111111111111111111111111111
1P00000000000000000000000000000000000000000000011
1111111111111110000000000000000000000000000000011
1000000000000000000000000000000000000000000000011
1000000000111111111000000000000000000000000000011
1000000000100000011000000000000000000000000000011
1000000000100000011000000000000000000000000000011
1000000000100000011000000000000000000000000000011
1000000000111111111000000000000000000000000000011
1000000000000000000000000000000000000000000000011
1000000000111111111000000000000000000000000000011
1000000000100000011000000000000000000000000000011
1000000000100000011000000000000000000000000000011
1000000000100000011000000000000000000000000000011
1000000000111111111000000000000000000000000000011
1000000000000000000000000000000000000000000000011
1000000000111111111111111111111111111000000000011
1000000000000000000000000000000000111000000000011
1000000000000000000000000000000000111000000000011
1000000000111111111000000000000000111000000000011
1000000000000000011000000000000000111000000000011
1000000000000000011000000000000000111000000000011
1000000000000000011000000000000000111000000000011
100000C000000000011111111111111111111111111110011
1000000000000000000000000000000000000000000000011
100000C000111111111111111111111111111111111000011
1000000000000000000000000000000000000000000000011
1111111111111111111111111111111111111111111111E11
1111111111111111111111111111111111111111111111111