11111111111111111111111111111111111111111111111111111111111111111111111111111111111111111111111111111
1P000000000000000000000000000000000000000000000110000000000000000000000000000000000000000000000000011
11111111111111100000000000000000000000000000000110000000000000000000000000000000000000000000000000011
10000000000000000000000000000000000000000000000110000000000000000000000000000000000000000000000000011
10000000001111111110000000000000000000000000000110000000000000000000000000000000000000000000000000011
10000000001000000110000000000000000000000000000110000000000000000000000000000000000000000000000000011
10000000001000000110000000000000000000000000000110000000000000000000000000000000000000000000000000011
10000000001000000110000000000000000000000000000110000000000000000000000000000000000000000000000000011
10000000001111111110000000000000000000000000000110000000000000000000000000000000000000000000000000011
10000000000000000000000000000000000000000000000110000000000000000000000000000000000000000000000000011
10000000001111111110000000000000000000000000000110000000000000000000000000000000000000000000000000011
10000000001000000110000000000000000000000000000110000000000000000000000000000000000000000000000000011
10000000001000000110000000000000000000000000000110000000000000000000000000000000000000000000000000011
10000000001000000110000000000000000000000000000110000000000000000000000000000000000000000000000000011
10000000001111111110000000000000000000000000000110000000000000000000000000000000000000000000000000011
10000000000000000000000000000000000000000000000110000000000000000000000000000000000000000000000000011
10000000001111111111111111111111111110000000000111000000000100000000010000000001000000000100000000011
10000000000000000000000000000000001110000000000111000000000100000000010000000001000000000100000000011
10000000000000000000000000000000001110000000000111000000000100000000010000000001000000000100000000011
10000000001111111110000000000000001110000000000111000000000100000000010000000001000000000100000000011
10000000000000000110000000000000001110000000000111000000000100000000010000000001000000000100000000011
10000000000000000110000000000000001110000000000111000000000100000000010000000001000000000100000000011
10000000000000000110000000000000001110000000000111000000000100000000010000000001000000000100000000011
100000C0000000000111111111111111111111111111100111111111110111111111011111111101111111110111111111011
10000000000000000000000000000000000000000000000110000000000000000000000000000000000000000000000000011
100000C0001111111111111111111111111111111110000111111111000111111100011111110001111111000111111100011
10000000000000000000000000000000000000000000000110000000000000000000000000000000000000000000000000011
1111111111111111111111111111111111111111111111E111111111111111111111111111111111111111111111111111111
11111111111111111111111111111111111111111111111111111111111111111111111111111111111111111111111111111