1111111111111111111111111111111
1P00000000000000000000000000011
1111111111111111111111111000011
1000000000000000000000111000011
1011111111111111111110111000011
1010000000000000000000111000011
1010111111111111111111111000011
1010100000000000000000000000011
1010101111111111111111111111011
1010101000000000000000000001011
1010101011111111111111111001011
1010101010000000000000001001011
1010101010111111111111101001011
1010101010100000000000101001011
1010101010101111111110101001011
10101C1010101000000000101001011
1010101010101011111110101001011
1010101010101010000000101001011
1010101010101010111111101001011
1010101010101010100000001001011
1010101010101010101111111001011
1010101010101010101000000001011
1010101010101010101011111111011
1010101010101010101010000000011
1010101010101010101010111111111
1010101010101010101010100000001
1010101010101010101010111111111
1010101010101010101010000000011
1010101010101010101011111111011
1010101010101010101000000001011
1010101010101010101111111001011
1010101010101010000000001001011
1010101010111111111111101001011
1010101010000000000000001001011
1010101011111111111111111001011
1010101000000000000000000001011
1010101111111111111111111111011
101000000000000000000000000E011
1111111111111111111111111111111
