1111111
1111111
110C111
11E1111
11P1111
1111111
